5497,5544,5545,5546,5547,5544,5545,5546,5547,5544,5545,5546,5547,5544,5545,5546,5547,5544,5545,5546,5547,5547,5544,5545,5546,5547,5547,5544,5545,5546,5547,5544,5545,5546,5547,5544,5545,5546,5547,5497,
5497,0,0,0,0,0,0,0,0,0,5514,0,0,0,0,0,0,0,0,5514,0,0,0,0,0,0,0,0,5514,0,0,0,0,0,0,0,5514,2607,2608,5497,
5497,0,0,0,0,0,0,0,0,0,5514,0,0,0,0,0,0,0,0,5514,0,0,0,0,0,0,0,0,5514,0,0,0,0,0,0,0,5514,2623,2624,5497,
5497,0,0,0,0,0,0,0,0,0,5514,0,0,0,0,0,0,0,0,5514,0,0,0,0,0,0,0,0,5514,5514,0,0,0,0,0,0,5514,0,0,5497,
5497,0,0,0,0,0,0,0,3819,3820,5514,0,0,0,0,0,0,0,0,5514,0,0,0,5514,0,0,0,0,0,5514,0,0,5514,0,0,0,0,0,0,5497,
5513,0,0,0,0,0,0,0,3835,3836,5514,0,0,0,0,5514,0,0,0,5514,0,0,0,5514,0,0,0,0,0,5514,0,0,5514,0,0,0,0,0,0,5497,
5529,0,0,0,0,0,0,0,0,0,0,0,0,0,0,5514,0,0,0,5514,0,0,0,5497,5733,5734,0,0,0,5514,0,0,5514,0,0,0,0,0,0,5497,
5545,0,0,0,0,0,0,0,0,0,0,0,0,0,0,5514,0,0,0,0,0,0,0,5513,5749,5750,0,0,0,0,0,0,5514,5514,5497,0,0,0,0,5497,
5497,5514,5514,5514,5514,5514,0,0,0,0,0,0,0,0,0,0,5497,0,0,0,0,0,0,5529,5512,5513,5514,5515,0,0,0,0,0,0,5513,0,0,0,0,5497,
5497,0,0,0,0,0,0,0,0,0,0,0,0,0,0,0,5513,0,0,0,0,0,0,5545,0,0,0,0,0,0,0,0,0,0,5529,0,0,0,0,5497,
5497,0,0,0,0,0,0,0,0,0,5512,5513,5514,5515,0,0,5529,0,0,0,0,0,0,0,0,0,0,0,0,0,0,0,0,0,5545,0,0,0,0,5497,
5497,0,0,0,0,0,0,0,0,0,5513,3439,3440,0,0,0,5545,0,0,0,0,0,0,0,0,0,0,0,0,0,0,0,0,0,5497,0,0,0,0,5497,
5497,4001,4002,4003,4004,0,0,0,0,0,5529,3455,3456,0,0,0,0,0,0,0,0,0,0,5512,5513,5514,5515,5512,5513,5514,5515,0,0,0,5513,0,0,0,0,5497,
5497,4017,4018,4019,4020,0,0,0,0,0,5545,3471,3472,0,0,0,0,0,0,0,0,0,0,0,0,0,0,0,0,0,0,0,0,0,5529,0,0,0,0,5497,
5497,5514,5514,5514,5514,5514,5514,0,0,0,5513,3487,3488,0,0,0,0,0,0,0,0,0,0,0,0,0,0,0,0,0,0,0,0,0,5545,0,0,0,0,5497,
5497,0,0,0,0,0,0,0,0,0,5529,5512,5513,5514,5515,5512,5513,5514,5515,5512,5513,5514,5515,0,0,0,0,0,0,0,0,0,0,0,5497,0,0,0,0,5497,
5497,0,0,0,0,0,0,0,0,0,5545,0,0,0,0,0,0,0,0,0,0,0,0,0,0,0,0,0,0,0,0,0,0,0,5513,0,0,0,0,5497,
5497,0,0,0,0,0,0,0,0,0,5497,0,0,0,0,0,0,0,0,0,0,0,0,0,0,0,0,5512,5513,5514,5515,0,0,0,5529,0,0,0,0,5497,
5497,5514,5514,5514,0,0,0,0,0,0,5513,0,0,0,0,0,0,0,0,0,0,0,0,0,0,0,0,5513,0,0,0,0,0,0,5514,0,0,0,0,5497,
5497,0,0,0,0,0,0,0,0,0,5529,0,0,0,5512,5513,5514,5515,5515,5515,5515,5515,5515,5515,5515,5515,5515,5529,0,0,0,0,0,0,5514,0,0,0,0,5497,
5497,0,0,0,0,0,0,0,0,0,5545,0,0,0,5514,0,0,0,0,0,0,0,0,0,0,0,0,5545,0,0,0,0,0,0,5514,0,0,0,0,5497,
5497,0,0,0,0,5497,0,0,0,0,0,0,0,0,0,0,0,0,0,0,0,0,0,0,0,0,0,5497,0,0,0,0,0,0,5514,0,0,0,0,5497,
5497,0,0,0,0,5513,0,0,0,0,0,0,0,0,0,0,0,0,0,0,0,0,0,0,0,0,0,5513,0,0,4015,4016,0,0,5514,0,0,0,0,5497,
5497,0,0,0,0,5529,0,0,0,0,0,0,0,0,0,0,0,5512,5513,5514,5515,5515,5515,5515,5515,5515,5515,5529,0,0,4031,4032,0,0,0,0,0,0,0,5497,
5497,0,0,0,0,5545,0,0,0,0,0,0,0,0,0,0,0,0,0,0,0,0,0,0,0,0,0,5545,0,0,4047,4048,0,0,0,0,0,0,0,5497,
5497,0,0,0,0,5512,5513,5514,5515,0,0,0,0,0,0,0,0,0,0,0,0,0,0,0,0,0,0,5497,0,0,0,0,0,0,0,0,0,0,0,5497,
5497,0,0,0,0,5513,0,0,0,0,0,0,0,5514,0,0,0,0,0,0,0,0,0,0,0,0,0,5513,0,0,0,0,0,0,0,0,0,0,0,5497,
5513,5701,5702,5701,5702,5529,0,0,0,0,0,0,0,5514,0,0,0,0,0,0,0,0,0,0,0,5733,5734,5529,0,0,0,0,0,0,0,0,0,2639,2640,5497,
5529,5717,5718,5717,5718,5545,0,0,0,0,0,0,0,5514,0,0,0,0,0,0,0,0,0,0,0,5749,5750,5545,0,0,0,0,0,0,0,0,0,2655,2656,5513,
5545,5544,5545,5546,5547,5547,5544,5545,5546,5547,5544,5545,5546,5547,5547,5547,5547,5547,5547,5547,5547,5547,5547,5547,5545,5546,5547,5547,5547,5547,5547,5547,5547,5547,5547,5547,5547,5547,5547,5547
