3,0,0,0,0,0,0,0,0,3,
3,2,2,2,2,2,2,2,2,3,
3,2,2,2,2,2,2,2,2,3,
3,2,2,2,2,2,2,2,2,3,
3,2,2,2,2,2,2,2,2,3,
3,2,2,2,2,2,2,2,2,3,
3,2,2,2,2,2,2,2,2,3,
3,2,2,2,2,2,2,2,2,3,
3,2,5,2,2,2,2,5,2,3,
3,0,6,6,6,6,6,6,0,3